{
    "latest": "20220409",
    "dates": [
        "20220306",
        "20220307",
        "20220308",
        "20220309",
        "20220310",
        "20220311",
        "20220312",
        "20220313",
        "20220314",
        "20220315",
        "20220316",
        "20220317",
        "20220318",
        "20220319",
        "20220320",
        "20220321",
        "20220322",
        "20220323",
        "20220324",
        "20220325",
        "20220326",
        "20220327",
        "20220328",
        "20220329",
        "20220330",
        "20220331",
        "20220401",
        "20220402",
        "20220403",
        "20220404",
        "20220405",
        "20220406",
        "20220407",
        "20220408",
        "20220409"
    ],
    "start": "20220306"
}