{
    "latest": "20220528",
    "dates": [
        "20220306",
        "20220307",
        "20220308",
        "20220309",
        "20220310",
        "20220311",
        "20220312",
        "20220313",
        "20220314",
        "20220315",
        "20220316",
        "20220317",
        "20220318",
        "20220319",
        "20220320",
        "20220321",
        "20220322",
        "20220323",
        "20220324",
        "20220325",
        "20220326",
        "20220327",
        "20220328",
        "20220329",
        "20220330",
        "20220331",
        "20220401",
        "20220402",
        "20220403",
        "20220404",
        "20220405",
        "20220406",
        "20220407",
        "20220408",
        "20220409",
        "20220410",
        "20220411",
        "20220412",
        "20220413",
        "20220414",
        "20220415",
        "20220416",
        "20220417",
        "20220418",
        "20220419",
        "20220420",
        "20220421",
        "20220422",
        "20220423",
        "20220424",
        "20220425",
        "20220426",
        "20220427",
        "20220428",
        "20220429",
        "20220430",
        "20220501",
        "20220502",
        "20220503",
        "20220504",
        "20220505",
        "20220506",
        "20220507",
        "20220508",
        "20220509",
        "20220510",
        "20220511",
        "20220512",
        "20220513",
        "20220514",
        "20220515",
        "20220516",
        "20220517",
        "20220518",
        "20220519",
        "20220520",
        "20220521",
        "20220522",
        "20220523",
        "20220524",
        "20220525",
        "20220526",
        "20220527",
        "20220528"
    ],
    "start": "20220306"
}